MAG	CDS	rRNA	tmRNA	tRNA	total
MAG128	2050	0	1	31	2082
MAG137	2991	4	0	39	3034
MAG212	2244	1	1	40	2286
MAG237	2312	0	1	37	2350
MAG238	1626	2	1	29	1658
MAG248	4542	0	0	33	4575
MAG253	1482	3	1	34	1520
MAG270	2417	1	1	34	2453
MAG298	1732	2	1	37	1772
MAG31	1813	2	1	34	1850
MAG60	2131	1	0	38	2170
